1394582708000
1394856002000
1397098801000
1397962800000
1399086000000
1400727600000
1403146800000
1403406000000
1404608400000
1406426400000
1405040400000